0101010101
0        0
1        1
0        0
1  0230  1
0  1040  0
1        1
0        0
1        1
0101010101