0000000000
1        1
1        1
12222    1
1        1
1    00001
1        1
12222    1
1        1
0000000000