0101010101
0        0
1        1
0     3  0
1        1
0  2     0
1 22     1
0        0
1        1
0101010101